16 11
500 350
1 1 1 1 1 1 1 2 2 1 1 1 1 1 1 1
1 1 1 1 0 1 1 2 2 1 1 1 1 1 1 1
1 1 1 1 2 2 2 2 2 1 1 1 1 1 1 1
1 1 1 2 2 2 2 2 2 1 1 1 1 1 1 1
2 2 2 2 2 2 2 2 2 1 1 1 1 1 1 1
2 2 2 2 2 2 2 2 2 2 2 2 2 2 2 2
1 1 2 2 2 2 2 2 2 2 2 2 2 2 2 2
1 1 2 2 2 2 2 2 2 2 2 2 2 2 1 1
1 1 2 2 2 2 2 2 2 2 2 2 2 2 1 1
1 1 1 1 1 1 1 1 1 1 1 1 1 1 1 1
1 1 1 1 1 1 1 1 1 1 1 1 1 1 1 1